#####################
# O   X        O    #
# O  X     X        #
#                   #
#    ###            #
#      #         ####
#      X       ## O #
# ###        ##     #
#         ###       #
#                   #
#         #         #
#         #     O   #
#   X P    # #      #
#####################